giftig - poisonous(ly)
im Freien - in the outdoors
die Haut - skin
das Insekt - insect
der Insektenschutz - insect repellent
das Netz - net
der Pilz - mushroom, toadstool
der Schutz - protection
übernachten - to spend the night
die Abneigung - dislike, aversion
das Boot - boat
erholsam - relaxing, refreshing
frustriert - frustrated(ly)
der Harz - Harz Mountains (Mountains in Germany)
langweilen (sich) - to be bored
die Ruhe - quiet, rest
der Urlaubsgruß - greeting from vacation
buchen - to book
eben - here: just (It’s just not so easy.)
irgendwo - somewhere
losfahren - to get going, to drive off
spontan - spontaneous(ly)
die Urlaubsplanung - vacation planning
der Urlaubstyp - vacation type
das Urlaubsziel - vacation destination
erholen (sich) - to recover, relax
der Feierabend - end of work, closing time
der Skype-Dialog - Skype dialogue
sorry - sorry
aktiv - active(ly)
begegnen - to encounter
entspannend - relaxing
faulenzen - to loaf around
inklusive - inclusive of, including
die Kreuzfahrt - cruise
das Wellnesshotel - spa hotel
der Stopp - stop (We’re having a stop in Berlin.)
die Fahrt - drive, ride
der Flug - flight
inbegriffen - included
die Vollpension - full board, meals included
zwar - here: namely (I’d like to book a trip (namely) to Spain.)
ausruhen (sich) - to take a rest
beraten - to advise
bügeln - to iron
das Kinderland - kids zone
nutzen - to use, take advantage of
pur - pure(ly)
reinigen - to clean, launder
der Top-Koch - top chef (m.)
verwöhnen - to spoil, pamper
der Luxus - luxury
der Bescheid - clue, idea (to let s.o. know) (We know for sure.)
die Bewertung - assessment, valuation
immerhin - after all
kulinarisch - culinary, culinarily
Glück gehabt - lucky
der Dusel - luck, fluke
der Massel - pig, here: luck
wiederbekommen - to get back
erleichtert - relieved
erschrecken - to become scared
der Flugbegleiter - flight attendant (m.)
das Gepäckfach - luggage compartment
die Passkontrolle - passport control
die Sitzreihe - seating row
verhaften - to arrest
verlegen - embarrassed (He was embarrassed because she was so nice to him.)
verzweifelt - desperate(ly)
die Botschaft - embassy
die Grenze - border
das Konsulat - consulate
das Visum - visa
der Zoll - customs
der Ausgang - exit
diktieren - to dictate
das Essen - food
das Gepäckband - luggage carousel
die Alm - meadow, high altitude pasture
der Almsommer - Alpine summer
der Almurlaub - Alpine vacation
das Ehepaar - married couple
eher - rather, quite
die Einsamkeit - here: solitude
erholt - recovered
falls - in case
fassen - here: to believe (I can hardly believe that I’m going home tomorrow.)
freuen (sich) (auf + Akk.) - to look forward to (I’m looking forward to my holidays.)
die Käserei - cheesemaking factory
melken - to milk
mithelfen - to help s.o.
der Rückblick - review, look back
der Sonnenaufgang - sunrise
der Wanderer - hiker, walker, wanderer
die Weide - pasture
der Wunderkräutertee - miracle herbal tea
zurückgehen - to go back (He’s going back home.)
der Almaufenthalt - Alpine visit
mitarbeiten - to work together, to work with s.o.
die Einparkhilfe - parking sensor
das Hawk-Eye - hawk eye
die Kassette - cassette
der Kopfhörer - headphones
die Neuerung - innovation
der Schiedsrichter - referee
technisch - technical(ly)
der Türöffner - door opener
der Walkman - walkman, portable cassette player
der Zahlencode - numerical code
die Zeitschaltuhr - timer
das Aus - here: out of bounds
dabei - considering
darum - that’s why (I didn’t pay attention, that’s why I lost my call phone.)
der Gegner - opponent
das Muss - must
schauen - to look
das Taschenbuch - paperback
unfair - unfair
der CD-Player - CD player
die Jugend - youth
seitdem - since then
übersetzen - to replace
der Akku - battery
ausgehen - to run out, go out
der Erfahrungsbericht - field report
die Funktion - function
die Kaufentscheidung - purchasing decision
der Elektronikmarkt - electronics store
elektronisch - electronic(ally)
die Fachzeitschrift - trade journal
der Freundeskreis - circle of friends
die Kundenbewertung - customer review
der Markt - market
das Sonderangebot - special offer
der Testbericht - review
der Werbeprospekt - advertising brochure
die Münze - coin
werfen - to throw, toss
das Kabel - cable
der Monitor - monitor
der Schalter - switch
die Steckdose - power outlet, socket
der Stecker - plug
klingen - to sound
unfreundlich - unfriendly
der Kasten - box
anschalten - to turn on
anschließen - to connect
drucken - to print
das Elektrogeschäft - electronics store
der Farbdrucker - color printer
farbig - colorful
die Farbpatrone - color ink cartridge
die Patrone - ink cartridge
die Reklamation - complaint
smart - smart, intelligent(ly)
die Vorstellung - vision, imagination
der Adressat - recipient, addressee
ändern - to alter
apropos - by the way, speaking of
auffallen - to stand out
bemerken - to notice
berühren - to touch
die Computerstimme - computerized voice
hereinkommen - to come in
hinsehen - to look closely
klicken - to click
die Kosten - costs
der Mitbewohner - roommate, flatmate
der Neubau - new building
speichern - to store, save
umsehen (sich) - to look around
die Videonachricht - video message
die Zentrale - headquarters
heimkommen - to come home
die Hightech-Wohnung - high-tech apartment
steuern - to control, manage
wessen - whose (Whose Auto is that?)
anpassen - to adapt, customize
das Gehalt - salary
trotz - despite (Despite the heat, I'm cold.)
wegen - because of
entsprechen - to correspond
beeindruckt - impressed
der Rollschuh - roller skate
die Werbeanzeige - advertisement
die Beschleunigung - accelleration
die Bio-Limonade - organic lemonade
die Brille - glasses
das Gesicht - face
die Optik - optics
der Tierpark - zoo
der Zoo - zoo
das Aspirin - aspirin
frech - cheeky, sassy
geschmacklos - tasteless
der Klebefilm - adhesive film
das Papiertaschentuch - paper tissue
der Süßstoff - sweetener
unmodern - unfashionable
der Werbetext - advertising copy
witzig - funny, humorous
davon - thereof
ansprechen - to appeal to, address
die Autofirma - car company
darüber - here: about that (I don't want to talk about that.)
darum - here: about that (It's about making people curious.)
deswegen - therefore, because of this
der Firmenname - company name
genügen - to suffice
der Genuss - indulgence, enjoyment
das Kaufverhalten - purchasing behavior
der Konsum - consumption
das Merkmal - characteristic
der Reim - rhyme
die Schönheit - beauty
der Slogan - slogan
der Stichpunkt - bullet point
das Verhalten - behavior
verständlich - understandable, understandably
die Werbebranche - advertising industry
werben - to advertise
die Werbesprache - advertising language
das Wortspiel - play on words, pun
zumindest - at least
die Zigarette - cigarette
der Geschmack - flavor, taste
der Ingwer - ginger
der Radiospot - radio ad
schmelzen - to melt
davon - here: from that
das Familienunternehmen - family business
der Fernsehredakteur - TV editor (m.)
die Fleischfabrik - meatpacking plant
gelähmt - paralyzed
die Grundidee - basic idea
kostbar - valuable, precious
künstlich - artificial
die Massenproduktion - mass production
der Nerv - nerve
der Optimismus - optimism
die Passivität - passivity
reich - rich
der Rollstuhl - wheelchair
die Sekunde - second
das Skirennen - skiing race
der Schlachthof - slaughterhouse
spüren - to sense
der Therapeut - therapist (m.)
überwinden - to overcome
der Umgang - handling
unterhalb - below
das Unternehmen - business, undertaking
die Verletzung - injury
vermitteln - to convey, impart
der Wille - will
die Wirbelsäule - spine
wertvoll - valuable
die Wurstwarenfabrik - sausage factory
der Zweifel - doubt
die Achtung - attention
unregelmäßig - irregular
das Altersheim - retirement home
der/die Angehörige - member, relative
die Arbeitserlaubnis - work permit
arbeitslos - unemployed
die Droge - drug
die Fortbildung - further education; continuing education
getrennt leben - to live separated
kündigen - to resign; to dismiss
der Nichtraucher - non-smoker
pflegen - to care for, maintain
die Rente - pension
die Scheidung - divorce
die Schwangerschaft - pregnancy
selbstständig machen - to be self-employed
sterben - to die
die Steuer - tax
süchtig - addicted (to become addicted to a drug)
die Teilzeit - part-time
die Therapie - therapy
der Tod - death
Vergangenes - past
der Anhang - appendix
der Autofahrer - car driver (m.)
der Autounfall - car accident
die Innenstadt - downtown
tauschen - to trade
die Trambahn - streetcar, tram
Die Sache mit dem Glück - The Thing with Happiness
die Übungssache - matter of practice
die Wirklichkeit - truth
das Zitat - quote
zusammentreffen - to meet, to encounter
berstellen - to construct, draw up
abraten - to advise against
bevor - before
dagegen - against s.t.
erwischen - to catch, nab
der Schmetterling - butterfly
tätig - active, working (to work)
verknallt - to have a crush on s.o.
während - during, throughout
aufgeben - to give up
der Ausschnitt - excerpt, clipping
die Beziehung - relationship
die Krise - crisis
der Neuanfang - new beginning
Positives - positive thing
die Liebesgeschichte - love story
niemals - never
wegziehen - to move away
ziehen - to move
sodass - so that
vermissen - to miss s.o.
das Dilemma - dilemma
zurückbekommen - to get back
zwar - here: though
die Erziehung - education, training
verletzen - to injure
das Zebra - zebra
der Zitronenbaum - lemon tree
Die Wende - The Turn
die Bundesrepublik - federal republic
geteilt - divided
die Wende - turn
anstehen - to stand in line
die DDR - German Democratic Republic
demokratisch - democratic(ally)
errichten - to establish, set up
fliehen - to flee, escape
die Gründung - establishment
die Republik - republic
der Weltkrieg - world war
ausgestattet - equipped
die Demokratie - democracy
einzigartig - unique, singular
entgegenströmen - to stream toward
erfahren - to learn, find out, experience
fallen - to fall
fordern - to demand
die Geschichte - history
grandios - grandiose
der Grenzübergang - border crossing
heutig - present-day
Hunderttausende - hundreds of thousands
jubeln - to cheer
klopfen - to knock
die Menschenmasse - crowd, mass
der Plastikbecher - plastic cup
reichen - to pass; to hand
rennen - to run
der Sektbecher - cup of champagne
die Sektflasche - champagne bottle
der Sozialkundeunterricht - social studies class
stolz - proud
strömen - to stream
der Trabi - Trabant (East German car)
umarmen - to embrace, hug
vergleichbar - comparable
die Wahl - elections
die Wiedervereinigung - reunion
wildfremd - completely strange
worum - about what
der Erzähler - narrator (m.)
die Analyse - analysis
bearbeiten - to work on, process, edit
die Briefträgerin - postal carrier (f.)
die Chemikerin - chemist (f.)
die Elektronik - electronics
die Fremdsprachenkenntnis - knowledge of foreign languages
geregelt - controlled, orderly, settled
das Labor - laboratory
die Mechatronikerin - mechanical electronics engineer (f.)
das Metall - metal
ernst nehmen - to take s.o. or s.t. seriously
die Herausforderung - challenge
regeln - to regulate, control
die Wissenschaftlerin - scientist (f.)
die Akte - file, record
der Bauer - farmer (m.)
die Gesellschaft - company, corporation, society
der Händler - dealer, trader (m.)
der Handwerker - artisan (m.)
die Menschenkenntnis - people skills
der Politiker - politician (m.)
der Reporter - reporter (m.)
der Richter - judge (m.)
die Schreinerin - carpenter (f.)
rechnen - to calculate
Gespräche bei der Arbeit - Conversations at Work
fortsetzen - to continue, resume
Wenn etwas schiefgeht … - When Things Go Wrong...
schiefgehen - to go wrong
bekleckern - to stain
das Diagramm - diagram
die Lieblingskollegin - favorite colleague (f.)
parken - to park
schütten - to spill
verzeihen - to forgive, excuse, pardon
die Verzeihung - forgiveness, pardon
die Wahrheit - truth
Die richtige Bewerbung - The Right Application
ankommen (auf + Akk.) - to arrive (at/about)
die Bewerbung - application
akzeptieren - to accept
der Arbeitgeber - employer
aussagekräftig - meaningful
die Bescheinigung - certificate
der Bewerber - applicant
das Bewerbungsschreiben - cover letter
das Bewerbungstraining - job application training
die Bewerbungsunterlagen - application materials
darauf - in that, in it
darin - in there
das Dokument - document
die Institution - institution
losschicken - to send off
die Mail-Adresse - mailing address
das PDF-Dokument - PDF document
der Personalchef - HR director
relevant - relevant
selbstverständlich - obvious(ly)
seriös - serious, respectable
speziell - special(ly), specific(ally)
der Stand - status, standing
die Unterlage - document, base
unterscheiden - to distinguish, differentiate
das Vorstellungsgespräch - interview
zukünftig - future
beziehen (sich auf + Akk.) - to refer to
freuen (sich über + Akk.) - to be pleased (about)
verzichten - to abstain,
er Faktor - factor
inhaltlich relevant - thematically relevant
konservativ - conservative(ly)
die Körperhaltung - posture
die Körpersprache - body language
vor lauter - out of sheer, total
locker - casual(ly), loose(ly)
meistern - to master
menschlich - human(ly)
das Outfit - outfit
die Persönlichkeit - personality
signalisieren - to signal
verhindern - to prevent, avert
die Werbeagentur - advertising agency
Recycling - recycling
die Region - region
der Transportweg - transport corridor
die Umwelt - environment
die Verpackung - packaging
der Anteil - amount
der Band - volume
das Bio-Fleisch - organic meat
dick - thick
der Fleischkonsum - meat consumption
die Gebühr - fee, tax
die Gesamtbevölkerung - total population
der Güterzug - freight train
die Herkunft - origin
das Huhn - chicken
konstant - constant(ly)
die Marke - brand
der Marktanteil - market share
das Material - material
die Menge - amount, quantity
mitrechnen - to add in, include
der Mond - moon
die Müllabfuhr - trash removal
die Mülltrennung - waste sorting
das Nahrungsmittel - foodstuff
der Papierverbrauch - paper use
die Produktion - production
rein - pure(ly)
relativ - relative(ly)
das Schaf - sheep
statistisch - statistically
die Tonne - ton
transportieren - to transport
der Trend - trend
das Trinkwasser - drinking water
der Umweltschutz - environmental protection
das Verpackungsmaterial - packaging material
verspeisen - to consume
die Ziege - goat
zirka (= circa) - about, circa
die Bettdecke - bedcover, duvet
die Büchse - tin can
die Drogerie - drug store
die Decke - ceiling, blanket
Eisenbahn - train
elektrisch - electric(ally)
der Fisch - fish
die Frucht - fruit
das Hackfleisch - ground meat
der Hut - hat
die Kerze - candle
die Vase - vase
die Zahnbürste - toothbrush
die Zahncreme - toothpaste
der Begriff - term
berechnen - to calculate
der Fußabdruck - footprint
ökologisch - ecological(ly)
Das Ökoduell - The Eco Duel
die Badewanne - bathtub
behandeln - to treat
die Chemikalie - chemical
die Duschzeit - shower duration
der E-Book-Leser - e-book reader
der E-Book-Reader - e-book reader
effizient - efficient(ly)
das Erdöl - crude oil, petroleum
gedruckt - printed
der Geschirrspüler - dishwasher
der Gewinner - winner
herstellen - to produce, manufacture
die Maschine - machine
die Ökobilanz - ecobalance, life-cycle assessment
die Papiertüte - paper bag
die Plastiktüte - plastic bag
reißen - to tear
die Stofftasche - cloth bag
das Treibhausgas - greenhouse gas
umweltfreundlich - environmentally friendly
verbrauchen - to consume, use up
die Wahl - choice
der Wasserverbrauch - water consumption
der Zeitraum - time period
Autofahren - car driving
das Modell - model
die Aktion - action, campaign
das Argument - argument
contra - against, con
die Diskussion - discussion
der/die Einzelne - individual
das Gegenteil - contrary, opposite
das Gesetz - law
der Staat - state
der Standpunkt - position, viewpoint
überzeugt - convinced
die Verantwortung - responsibility
verhalten (sich) - to behave, restrain (behavior)
widersprechen - to contradict, disagree
Nur Papier? - Just Paper?
die Briefmarke - postage stamp
der Briefumschlag - envelope
der Geldschein - bill, banknote
das Geschenkpapier - wrapping paper
abgeschliffen - ground, mulched
Ägypten - Egypt
alltäglich - commonplace, ordinary
annehmen - to accept, take on
ausdrucken - to print out
der Chinese - Chinese person
davor - before that
dünn - thin(ly)
der Einfluss - influence
entwickeln - to develop
die Erfindung - invention
erstmals - for the first time
der Experte - expert (m.)
geheim - secret(ly)
die Herstellung - manufacture
die Holzfaser - wood fiber
die Illusion - illusion
der Klebezettel - sticky note
die Massenware - mass-produced commodity
die Methode - method
die Papierherstellung - paper manufacture
papierlos - paperless(ly)
die Pappe - cardboard
der Papyrus - papyrus
die Pflanzenfaser - plant fiber
der Pflanzenstiel - plant stem
pressen - to press
prophezeien - to predict
die Scheibe - disk, sheet, slice
das Schreibmaterial - writing material
sicherlich - sure(ly)
der Stofflumpen - cloth rags
die Tontafel - clay tablet
der Verbrauch - consumption
verbreiten - to spread, disseminate
vor allem - above all, particularly
das Werbematerial - advertising material
der Stoff - cloth, textiles
die Wolle - wool
das Leder - leather
der Affe - monkey, ape
der Automat - machine, vending machine
die Bezeichnung - designation, symbol
der Diplomat - diplomat (m.)
der Konsument - consumer
der Löwe - lion
der Pädagoge - pedagogue (m.)
der Praktikant - intern, trainee (m.)
heben - to lift
monoton - monotonous(ly)
der Sprechrhythmus - rhythm of speech
Das Wetter in D-A-CH - The Weather in Germany-Austria-Switzerland
bewölkt - cloudy
blitzen - to flash lightning
donnern - to thunder
feucht - moist, humid
das Gewitter - thunderstorm
hageln - to hail
neblig - foggy
nieseln - to drizzle
regnerisch - rainy
schwül - muggy
sonnig - sunny
stürmisch - stormy
wolkig - cloudy
die Höchsttemperatur - maximum temperature
das Regenrisiko - chance of rain
das Risiko - risk, chance
schütten - to pour (The weather is bad, it's pouring.)
der Smalltalk - small talk
die Wetterbesserung - weather improvement
die Vorhersage - forecast
die Wettervorhersage - weather forecast
das Gedächtnis - memory
die Wortfamilie - word family
der Sturm - storm
Engagement für die Natur - Engagement for nature
alle - all (all kinds of) (People are planting all kinds of flowers.)
der Anwohner - local residents
aussterben - to die off
der Autoverkehr - vehicle traffic
bestätigen - to confirm
die Blumenzwiebel - flower bulb
Dutzende - dozens
der Eimer - bucket
das Engagement - commitment, involvement
der Frosch - frog
gesperrt - closed, blocked
das Guerilla Gardening - guerilla gardening
handeln - to concern (It concerns public places.)
illegal - illegal(ly)
irgendjemand - someone
irgendwann - sometime
die Kröte - turtle
die Krötenwanderung - turtle migration
die Mühe - effort
opfern - to sacrifice
pflanzen - to plant
retten - to rescue
die Straßenseite - side of the street
der Teich - pond
der Tunnel - tunnel
vergraben - to bury
verschönern - to beautify
das Verständnis - understanding, sympathy
vielerorts - in many places
die Vorfahrt - right-of-way
die Astrologie - astrology
die Handlinie - hand line
das Schicksal - fate
der Spruch - saying
das Sternzeichen - star sign
die Tradition - tradition
die Antike - antiquity
der Astrologe - astrologer (m.)
die Auseinandersetzung - discussion, dispute
äußerst - extremely, exceedingly
die Bauernregel - weather lore
beschäftigen - to busy, occupy
das Blei - lead
das Bleigießen - lead casting
der Boden - floor, bottom, ground
der Brauch - custom
der Charakter - character
derzeit - at present
der/die Erste - first one
die Figur - figure
flüssig - fluid(ly)
fruchtbar - fruitful, prolific
das Gebäck - cookie
geduldig - patient(ly) (to be patient)
das Gegenüber - counterpart
der Glückskeks - fortune cookie
das Handlesen - hand reading
heutzutage - nowadays
das Horoskop - horoscope
indianisch - Indian
das Kaffeepulver - coffee grounds
der Kaffeesatz - coffee grounds, dregs
die Kaffeetasse - coffee cup
kleben - to stick
die Lebensdauer - lifespan
die Linie - line
der Mars - Mars
mithilfe (+ Genitiv) - with the help of; here: using
das Mokkapulver - coffee grounds
das Muster - pattern
die Partnerschaft - partnership
respektieren - to respect
der Rückhalt - support, backing
der Schatten - shadow
der Skorpion - Scorpio, scorpion
teilen - to share (I don't share your opinion.)
unschlagbar - unbeatable, invincible
vermeiden - to avoid, avert
vorhersagen - to foresee, forecast
die Waage - Libra, scales
zweifeln - to doubt, be skeptical
die Zukunftsprognose - future forecast
die Jungfrau - Virgo
der Krebs - Cancer, crab
der Schütze - Sagittarius, archer
der Steinbock - Capricorn
der Stier - Taurus, bull
der Wassermann - Aquarius
der Widder - Aries
der Zwilling - Gemini, twin
Gute Vorsätze - Good resolutions
befragen - to question, consult
der Erzieher - educator, tutor (m.)
fassen - to take hold of, grip here: to make (Every morning I make a good resolution for the day.)
der Leser - reader, lecturer (m.)
Süßes - sweet
der Vorsatz - resolution
vorhaben - to have planned
vornehmen (sich) - to carry out
Neu in der Firma - New at the company
vorne (da hinten) - over there (over there)
der Wurf - throw
würfeln - to roll dice
Hamburg 2030 - Hamburg 2030
das Freizeitangebot - recreational activity
das Älterwerden - aging
das Bedürfnis - need, desire
die Betreuung - care, supervision
die Bevölkerung - population
darunter - among them
dicht - dense
die Erholungsmöglichkeit - recreational opportunity
die Fachleute - professionals
das Fünftel - fifth
die Ganztagsschule - day school
kulturell - cultural(ly)
olympisch - olympic
politisch - political(ly)
die Pressekonferenz - press conference
das Radwegnetz - network of bicycle paths
repräsentieren - to represent
superschnell - ultrafast
wirtschaftlich - economic(ally)
die Wohnform - form of housing
der Wohnungsbau - residential building
das Zukunftscamp - future camp
der Altersdurchschnitt - average age
berücksichtigen - to consider
der Fahrradfahrer - cyclist
die Wohnsituation - living situation
aufwachsen - to grow up
der Bürger - citizen
die Olympiade - Olympic games
die Bildung - education, formation
die Verkehrssituation - traffic situation
der Wohnraum - living space
Leb' deine Träume - Live your dreams
der Rhythmus - rhythm
der Refrain - refrain
der Sieger - winner, victor
auswendig - from memory
der Himmel - sky
hinhören - to listen closely
inner - inner
irren - here: to stray, roam about
das Labyrinth - labyrinth
mithören - to listen with someone
mitsingen - to sing with someone
der Mut - courage
trauen (sich) - to trust
wagen - to dare, risk
bereit - prepared
besiegen - to defeat
das Dunkle - darkness
das Helle - light
kämpfen - to fight
der Bass - bass
der Gesang - singing
das Keyboard - keyboard
das Schlagzeug - drums, percussion
die Single - single
Amerika - America
der Song - song
Die Beziehungskiste - Relationship box
einparken - to park
nerven - to annoy
gepflegt - neat, refined
der Humor - humor
kleiden (sich) - to dress
natürlich - natural (You look very natural without makeup.)
schlank - slender
die Traumfrau - dream woman
der Traummann - dream man
die Studie - study
die Einschätzung - assessment, estimation
ängstlich - anxious(ly), fearful(ly)
blond - blond
dunkelhaarig - dark-haired
faul - lazy, lazily
klug - wise(ly), clever(ly)
kräftig - strong(ly)
mutig - brave(ly)
optimistisch - optimistic(ally)
pessimistisch - pessimistic(ally)
schwach - weak(ly)
unehrlich - dishonest(ly)
untreu - unfaithful(ly)
unzuverlässig - unreliable (unreliably)
Eine Familie als Patchwork - A family as patchwork
das Patchwork - patchwork
die Patchwork-Familie - patchwork family
bald - soon thereafter
die Beratung - advice, consultation
die Beratungsstelle - counseling center
das Ende - end (to be at the end)
jetzig - current, present
klarkommen - to cope (I can't cope with this.)
der Kompromiss - compromise
scheiden lassen (sich) - to divorce
setzen - to set (to set boundaries)
der Sponsor - sponsor
der Streit - dispute, argument
tagelang - for days
verwandt - related
wahnsinnig - insane(ly), crazy, crazily
der Zahn - tooth
zusammenbleiben - to stay together
zusammenleben - to live together
einziehen - to move in (Elisa is moving in with Tom and Nina.)
trennen (sich) - to separate
die Gegenwart - present time, presence
Vergangenheit - past
abspülen - to rinse
ätzend - caustic(ally), lousy, lousily
Blödmann - buffoon, blockhead
Dusche - shower
endlos - endless(ly)
Halbzeit - halftime
krass - crass, harsh
nachdem - after
Neuigkeit - news
schick - chic, fancy
worüber - about what
bis - until, up to
erschöpft - exhausted
eskalieren - to escalate
gefallen lassen - to put up with, tolerate
gelingen - to succeed
Gift - poison
Goldwaage - balance, scales
Harmonie - harmony
Ich-Aussage - I-statement
Kritik - criticism
nachgeben - to give in, yield
ruhig bleiben - to stay calm
schweigen - to remain silent
tolerant - tolerant(ly)
geeignet - suitable, suitably
diplomatisch - diplomatic(ally)
Streitgespräch - argument, debate
undiplomatisch - undiplomatic(ally)
Aufforderung - request, challenge
Gemeinsam sind wir stark - Together we are strong
arm - poor(ly)
Atelier - studio
beeinflussen - to influence
erkämpfen - to win, secure
finanziell - financial(ly)
Gewalt - force, violence
Kampf - battle, fight
kommerziell - commercial(ly)
komponieren - to compose
Komponist - composer (m.)
Kunsthistoriker - art historian (m.)
Pianistin - pianist (f.)
Schauspielkarriere - acting career
unabhängig - independent(ly)
Verleger - publisher (m.)
voneinander - from one another
weiterhin - further
zunächst - for the time being
zwingen - to force
Moral von der Geschichte - Moral of the story
Moral - moral, lesson
abziehen - to move away, pull off
beißen - to bite
Beute - prey, quarry
Fabel - fable
Fuchs - fox
Hirsch - deer, stag
Jagd - hunt
Klügere - smarter one
kraftlos - powerless(ly)
lachend - laughing(ly)
Lebensweisheit - worldly wisdom
miteinander - with each other
verbissen - dogged(ly), grim(ly)
wehren - to defend
zornig - furious(ly)
zurückbrüllen - to yell back
zusammenbrechen - to collapse
aussagen - to testify, state
dorthin - there
eilig - hasty, hastily
fressen - to feed, eat
illustrieren - to illustrate
loben - to praise
Rabe - crow
schmeicheln - to flatter
Schnabel - beak
stehlen - to steal
Fliege - fly
Giraffe - giraffe
Krokodil - crocodile
Menschenleben - human life
Markierung - marking
Rede - speech
wörtlich - literal(ly)
beachten - to note, observe
Wertsachen - valuables
Alarmknopf - alarm button
Apparat - apparatus, machine
aufbewahren - to store, keep
Bademantel - bathrobe
beschildert - marked with signs
betragen - to come to
Chipkarte - smart card, keycard
Diät-Assistentin - dietary assistant
diätisch - dietary
ebenso - as well, likewise
eignen - to be suitable for
empfangen - to receive
Entlassung - discharge
erhalten - to get, obtain
Ernährung - nutrition
Fernbedienung - remote control
Festnetz - landline
Gebrauchsanweisung - user's manual
Hauptmahlzeit - main meal
Infoblatt - fact sheet
inkl. - incl. (inclusive)
Klinikaufenthalt - hospital stay
Küchenteam - kitchen staff
Mineralwasser - mineral water
Nachthemd - nightgown
Notausgang - emergency exit
Notfall - emergency
Nutzung - use
prinzipiell - in principle
Rücksicht - consideration
Rufnummer - telephone number
sämtlich - all
Schlafanzug - pajamas
Schließfach - lockbox, safe
sichtbar - visible, visibly
Trainingsanzug - track suit
vegetarisch - vegetarian
Zimmernachbar - next-door neighbor
Zimmertür - room door
zuständig - responsible
Zwischenmahlzeit - snack
Alles Musik - Everything Music
amerikanisch - American
auslösen - to trigger, release
Beerdigung - funeral
beobachten - to observe
beruhigend - soothing(ly), reassuring(ly)
Dur-Tonart - major key
entweder - either
feierlich - ceremonial(ly)
Filmbranche - film industry
Filmmusik - film score, film soundtrack
Forscher - researcher (m.)
gelangen - to reach, attain
Heavy Metal - heavy metal
Käsekuchen - cheesecake
Kopf - head
Kursstunde - class hour
Moll-Tonart - minor key
Musikgeschmack - music taste
Musikinstrument - musical instrument
Musikstudium - study of music
Puls - beat, pulse
Reklame - advertisement
Rolle - role
Salsa - salsa music
sinken - to fall, sink
sobald - as soon as
Sowohl - both
Staatsempfang - state reception
Techno - techno music
tragisch - tragic(ally)
verantwortlich - responsible
verarbeiten - to process, handle
vermutlich - presumably
Weder - neither
Würzig - aromatic, spicy
Forschungsthema - research topic
Krankenhaus - hospital
Krankenzimmer - hospital room
Nötig - necessary, required
Warnen - to warn
auflösen - to dissolve, resolve
einnehmen - to take in
Facharzt - medical specialist
Flüssigkeit - fluid
Hausarzt - general practitioner, family doctor
Pfleger - nurse (m.)
Pflegerin - nurse (f.)
Schwindlig - dizzy, dizzily
Unbequem - uncomfortable
Haar - hair
Kämmen - to comb
Partnerinterview - partner interview
Besuchszeit - visiting hours
Wertsachen - valuables
Alarmknopf - alarm button
Apparat - apparatus, machine
Aufbewahren - to store, keep
Bademantel - bathrobe
Beschildert - marked with signs
Betragen - to come to
Chipkarte - smart card, keycard
Diät-Assistentin - dietary assistant
Diätisch - dietary
Ebenso - as well, likewise
Eignen - to be suitable for
Empfangen - to receive
Entlassung - discharge
Erhalten - to get, obtain
Ernährung - nutrition
Fernbedienung - remote control
Festnetz - landline
Gebrauchsanweisung - user's manual
Hauptmahlzeit - main meal
Infoblatt - fact sheet
Inkl. - incl. (inclusive)
Klinikaufenthalt - hospital stay
Küchenteam - kitchen staff
Mineralwasser - mineral water
Nachthemd - nightgown
Notausgang - emergency exit
Notfall - emergency
Nutzung - use
Prinzipiell - in principle
Rücksicht - consideration
Rufnummer - telephone number
Sämtlich - all
Schlafanzug - pajamas
Schließfach - lockbox, safe
Sichtbar - visible, visibly
Trainingsanzug - track suit
Vegetarisch - vegetarian
Zimmernachbar - next-door neighbor
Zimmertür - room door
Zuständig - responsible
Zwischenmahlzeit - snack
Gedächtnisleistung - memory skills
anhaben - to wear, have on
Gedächtnisleistung - memory skills
Kursstunde - class hour
Woran - about what
Involviert - involved
der Lerncoach - learning coach
motiviert - motivated
die Programmankündigung - program announcement
die Radiodiskussion - radio discussion
das Sprachenlernen (Singular) - language acquisition
der Studiogast - studio guest
dauerhaft - permanent(ly)
die Lernmenge - amount to learn
der Moderator - moderator
der Stoff (Singular) - material, stuff (I still need to learn so much material for the test.)
die Strategie - strategy
die Tageszeit - time of day
ausdenken (sich) (denkt sich aus, dachte sich aus, hat sich ausgedacht) - to devise, think up
fantasievoll - imaginative(ly)
überprüfen - to check, verify
ungewöhnlich - unusual(ly)
der Lerntipp - learning tip
assoziieren - to associate
der Lernweg - learning track
ausgleichen - to compensate, even out
ausnahmslos - without exception
ausschließlich - exclusive(ly)
bemühen (sich) (um + Akk.) - to strive, trouble
beteiligen (sich) (an + Dat.) - to participate
der Betreuer - supervisor
dennoch - nevertheless
der Druck (Singular) - pressure
einbringen (bringt ein, brachte ein, hat eingebracht) - to bring in
entdecken - to discover
die Entwicklung - development
erarbeiten - to work for
das Feedback, -s (Feedback geben/erhalten/bekommen) - feedback (to give/receive/get feedback)
die Förderung - encouragement, advancement
die Gesamtschule - comprehensive school
das Halbjahr - half year
der Hinweis - clue, piece of advice
der Hirnforscher - brain researcher
die Jahrgangsstufe - grade
jedoch - however
der Klassenlehrer - classroom teacher
laut (Laut aktuellen Forschungen sollten Schüler Freude am Entdecken haben.) - according to (According to recent research, students should find joy in discovery.)
die Leistung - performance, achievement
der Lernbegleiter - learning companion
die Lernfreude (Singular) - joy of learning
der Lösungsweg - solution
der Matheprofi - math pro
die Nachmittagsstunde - afternoon session
nebeneinander (Wir sitzen nebeneinander.) - side by side (We're sitting side by side.)
offenbar - apparent(ly), obvious(ly)
der Schulpreis - school award
die Schwäche - weakness
untereinander - among themselves
der Unterrichtsstoff (Singular) - teaching material
unterstützen - to support
vertraut machen (sich) (mit + Dat.) - to become familiar with
die Wochenaufgabe - weekly homework
zugehen (geht zu, ging zu, ist zugegangen) (Hier geht es anders zu als an anderen Schulen.) - to deal with (Here, things are dealt with differently than in other schools.)
zutrauen (Niemand hat ihnen das Abitur zugetraut.) - to have confidence, to believe in something (No one believed that they could get their high school diploma.)
zusätzlich - additional(ly)
der Kunststück - piece of art, stunt
anschauen - to look at
das Auge - eye (to catch someone's eye)
die Bahnhofshalle - train station hall
Bosnien - Bosnia
der Brunnen - fountain
die Burg - castle
das Detail - detail
ein wenig - a little
das Exemplar - copy
flüchten - to flee
die Flüchtlingsfrau - female refugee
das Gemälde - painting
geometrisch - geometric(ally)
gewöhnlich - usual(ly), ordinary, ordinarily
greifen (greift, griff, hat gegriffen) - to grasp, reach for
das Handwerk (Singular) - craft
hierherkommen (kommt hierher, kam hierher, ist hierhergekommen) - to come here
hinaufgehen (geht hinauf, ging hinauf, ist hinaufgegangen) - to go up
die Kaiserin - empress
die Kette - necklace
die Kraft - strength, power
der Krieg - war (to wage war)
die Kunsterzieherin - art teacher (f.)
das Kunstwerk - artwork
die Kurve - curve
nähen - to sew, stitch
der Ohrring - earring
der Quilt - quilt
schätzen (Ich schätze dieses Gemälde sehr.) - to value, estimate (I really value this painting.)
die Schmuckdesignerin - jewelry designer (f.)
schöpfen (Kraft schöpfen) - to draw, summon up (to draw power)
schräg - oblique(ly), diagonal(ly)
senkrecht - vertical, perpendicular
die Statue - statue
die Stiege - stairs (Austria)
das Unikat - unique piece
waagerecht - horizontal
die Brieftasche - wallet, billfold
das Eck - corner (Austria)
der Erdapfel, Erdäpfel - potato (Austria)
der Fleischer - butcher
der Fleischhauer - butcher (Austria)
das Gasthaus - inn
die Gaststätte - restaurant
die Geldbörse - purse
das Kuvert - envelope (Austria)
der Metzger - butcher
die Ordination - (Austria)
das Streichholz - match
der Zünder - match (Austria)
das Zündholz - match
das Kunstobjekt - artwork
das Graffito, Graffiti - graffiti
die Schulklasse - classroom
der Amateur - amateur
aufführen - to perform, put on
ausmachen - to turn off
belastet - burdened
die Bühne - stage (to bring a play to the stage)
diesmal - this time
der Krankenpfleger - nurse (m.)
der Manager - manager
das Opfer - sacrifice
die Premiere - premiere
das Privatleben (Singular) - private life
die Regie (Singular) - direction
stumm - mute(ly), quiet(ly)
die Theaterleute (Plural) - theater professionals
das Theaterstück - play
die Aufführung - performance, show
die Ausstattung - equipment
der Bart, Bärte - beard
beleuchten - to light up
die Frisur - haircut
die Kulisse - backdrop
das Lampenfieber (Singular) - stage fright
die Lehne - backrest, armrest
die Nähmaschine - sewing machine
der Scheinwerfer - spotlight, headlight
die Schminke (Singular) - makeup
schminken - to make up
das Talent - talent
der Terminkalender - appointment calendar
die Theaterbühne - theatrical stage
die Tragödie - tragedy
vorhanden - existing, available
zaubern - to conjure
auftreten (tritt auf, trat auf, ist aufgetreten) - to occur, appear
das Ballett - ballet
die Broschüre - brochure
das Büfett - buffet
der Einfall, Einfälle - incidence, idea
erforderlich - required, necessary
die Garderobe - wardrobe
inszenieren - to stage, direct
die Qualifikation - qualification
die Schauspielschule - acting school
der Tanz, Tänze - dance
der Tänzer - dancer
der Theaterregisseur - theater director
das Inserat - advertisement, insert
erfahren (Wir suchen erfahrene Techniker.) - experienced (We are looking for experienced technicians.)
der Kursraum, Räume - classroom
die Motto-Party - themed party
die Musikgruppe - music group
das Sportteam - sports team
abkaufen - to buy from
ankommen (kommt an, kam an, ist angekommen) (bei + Dat.) - to arrive, come across (The photos were well-received by the visitors.)
die Auktion - auction
der Auktionator, Auktionatoren - auctioneer
der Auktionsbesucher - auction visitors
das Auktionshaus, Häuser - auction house
der Besitzer - owner
ehemalig - former(ly)
die Erbin, Erben - heiress
erzielen - to achieve, attain
gründlich - thorough(ly)
die Gummiwanne - rubber tub
herankommen (kommt heran, kam heran, ist herangekommen) - to come near
die Installation - installation
das Missgeschick - misfortune
original - original(ly)
der Perserteppich - Persian carpet
pfiffig - smart, clever
die Pflicht - duty
preiswert - inexpensive(ly)
prüfen - to test, probe, look into
die Putzfrau, Putzfrauen - cleaner (f.)
die Reinigungsfirma, Reinigungsfirma - cleaning service
das Reinigungspersonal (Singular) - cleaning staff
schätzen (auf + Akk.) (Das Auktionshaus schätzt den Wert des Kunstwerks auf 8000 Euro.) - to estimate, value (The auction house estimates the value of this piece of art at 8,000 Euro.)
schuldig - guilty, guiltily
staunen - to be astonished
tierisch - brutishly
verklagen - to sue
das Versehen - mistake, oversight
das Werk, Werke - work
zerstören - to destroy
der Zoodirektor, Zoodirektoren - zoo director
der Beispielsatz, Beispielsätze - example sentence
die Stellung, Stellungen (die Stellung im Satz) - position (the position within the sentence)
verneinen - to negate
die Putzfirma, Putzfirmen - cleaning service
einzeln - individual(ly)
nacheinander - successively
der Ausstellungsbesucher - exhibition visitors
abschwächen - to weaken, tone down
banal - banally
überzeugend - convincingly
verstärken - to strengthen
die Kopie, Kopien - copy
die Ankündigung, Ankündigungen - announcement
Argentinien - Argentina
der Austauschschüler - exchange student
der Dokumentarfilm, Dokumentarfilme - documentary film
der Dozent, Dozenten - lecturer, instructor
der Filmpreis, Filmpreise - film prize
das Gerichtsschiff, Gerichtsschiffe - floating courthouse
der Kinderfilm, Kinderfilme - children's film
der Produzent, Produzenten - producer
die Volksmusik (Singular) - folk music
der Drehtag, Drehtage - day of shooting
die Filmvorführung, Filmvorführungen - film screening
der Redakteur, Redakteure - editor
erwähnen - to mention
das Kurzporträt, Kurzporträts - brief portrait
begeben (sich) (begibt sich, begab sich, hat sich begeben) - to embark
die Entdeckungsreise, Entdeckungsreisen - voyage of discovery
Hip-Hop (Singular, ohne Artikel) - hip-hop
die Inhaltsbeschreibung, Inhaltsbeschreibungen - content description
jodeln - to yodel
die Kulturgrenze, Kulturgrenzen - cultural boundary
musikalisch - musically
musizieren - to play music
quer - crosswise
regional - regionally
die Sprachgrenze, Sprachgrenzen - language border
über … hinweg - beyond
das Verhältnis, Verhältnisse - relationship, ratio
das Volkslied, Volkslieder - folk song
einsperren - to lock up, confine
entzwei - in two, in half
erschießen (erschießt, erschoss, hat erschossen) - to shoot dead
finster - sinister, gloomy
das Gedicht, Gedichte - poem
der Jäger, Jäger - hunter
der Kerker, Kerker - dungeon
die Liedzeile, Liedzeilen - song line
nächtlich - nightly
rein - outright, pure(ly)
die Schranke, Schranken - barrier
vergeblich - in vain
vorbeifliegen (fliegt vorbei, flog vorbei, ist vorbeigeflogen) - to fly by
das Werk, Werke (vergebliche Werke) - work, deed (forgivable deeds)
zerreißen (zerreißt, zerriss, hat zerrissen) - to tear apart
Ehrlichkeit - Honesty

Fairness - Fairness

Gerechtigkeit - Justice

Gleichberechtigung - Equality

Hilfsbereitschaft - Helpfulness

Respekt - Respect

Toleranz - Tolerance

Wert - Value

Zivilcourage - Civic Duty

Zuordnung - Classification

abstimmen - to vote

Abgeordnete - Deputy

anwesend - Present

Aufnahme - Recording

begeistern - To inspire

behindert - Disabled

Blinde - Blind person

Bundeskanzler - Chancellor (male)

Bundeskanzlerin - Chancellor (female)

Bundestag - German legislature

Bürgermeister - Mayor

Einbürgerung - Naturalization

Einwanderer - Immigrant

humorvoll - Humorous

Integration - Integration

Kandidatin - Candidate (female)

körperlich - Physical

Migrant - Migrant

Minister - Minister

Partei - Political party

Politik - Politics

Publikum - Audience

Recht - Right, justice

Regierung - Government

Schwerpunkt - Focus

ausüben - To exercise

Religion - Religion

sichern - To secure

alarmieren - To alert

Arbeitssuche - Job search

ausbilden - To train

ausrücken - To move out, dispatch

Ausgabestelle - Distribution location

bedürftig - Needy

Behördengang - Visit to the authorities

Berufsfeuerwehr - Professional fire brigade

bewältigen - To overcome

Braten - Roast

brennen - To burn

ehrenamtlich - Voluntary

Feuerwehrleute - Firefighters

Hochwasser - Flood

Lehrgang - Training course

Margarine - Margarine

meist - Mostly

Möhre - Carrot

Nachtzeit - Nighttime

Organisation - Organization

Pate - Godparent

Patenschaft - Sponsorship

qualitativ - Qualitative

Schwierigkeit - Difficulty

Soße - Sauce

spenden - To donate

Verein - Association, club

Vereinsmitglied - Club member

vernichten - To destroy

wegwerfen - To throw away

Wohnungssuche - Apartment search

bundesweit - Nationwide

mittlerweile - In the meantime

Brand - Fire

löschen - To extinguish

entsorgen - To dispose of

Grundstück - Plot of land

Abzug - Deduction

anreisen - To travel to

auszahlen - To pay off

außerhalb - Outside

bereits - Already

drohen - To threaten

eintragen - To register, record

Einkauf - Purchase

eröffnen - To open

führen - To lead, run

global - Global

Halle - Hall

Hochschule - Institution of higher education

Indien - India

innerhalb - Within, inside

Jobcenter - Career center

Jugendgruppe - Youth group

mitspielen - To play with

Spielgeld - Play money

Spielstadt - Play city

Streik - Strike

Studienplatz - Place to study

Studienzeit - Time to study

Verkauf - Sale

ausgebildet - Trained

sauber halten - To keep clean

streiken - To go on strike

wegräumen - To put away

gell - Huh, right

hingehen - To go there

Norden - North

Süden - South

abräumen - To clear away

Lieferung - Shipment

Straßenlaterne - Streetlight

uninteressant - Uninteresting

EU - European Union

europäisch - European

Union - Union

beschließen - To decide on

dasselbe - The same

Dienstleistung - Service

EU-Land - EU country

Europäische Union - European Union

Gemeinschaft - Community

Grenzkontrolle - Border control

national - National

thematisch - Thematic

Vortrag - Lecture

bewahren - To keep, preserve

EU-Bürger - EU citizen

aufbauen - To build up, construct

Struktur - Structure

folgendermaßen - As follows

gegliedert - Structured

Abfall - Waste

Abgas - Exhaust

Betrieb - Operation, factory

Dreck - Dirt

Fahrbahn - Roadway

Fahrzeug - Automobile

Fußgängerzone - Pedestrian zone

Gebiet - Area, territory

Gehsteig - Sidewalk

Geschwindigkeit - Speed

Lärm - Noise

Rand - Edge, outskirts

Schaufenster - Display window

Schmutz - Dirt, grime

Stadtteil - Part of town, quarter

Stadtzentrum - City center

Tempo - Tempo, speed

Viertel - Quarter

Zone - Zone

Einkaufsstraße - Shopping street

angehen - To concern

Arbeitswoche - Workweek

dauernd - Constantly

Forumsname - Forum name

interkulturell - Intercultural
recht geben - To agree, concede
Shopping - Shopping
Stadtmensch - City person
Stadttyp - City person
Studentenleben - Student life
Landmensch - Country person
Stadtgarten - City garden
aufwachen - To wake up
geschehen - To happen, occur
Freizeitaktivität - Leisure activity
Tourismus - Tourism
freundlich - Friendly
geehrt - Honored
Geschäftspartner - Business partner
die Geschäftspartnerin, -nen - business partner (f.)
mitteilen - to tell, notify
die Spalte, -n - column
regieren - to rule, govern
anschaffen - to buy, get
der Beleg, -e - document, voucher
ernsthaft - serious(ly), earnest(ly)
die Mahnung, -en - reminder
sparsam - economical(ly), frugal(ly)
der Sportverein, -e - sports club
die Vereinskasse, -n - club treasury
der Bohnenkaffee - coffee beans
die Einheit, -en - unity
der Herrenanzug, -anzüge - men's suit
der Kleiderschrank, -schränke - wardrobe
das Mischbrot, -e - brown bread
das Schweinekotelett, -s - pork chop
die Vollmilch - whole milk
abheben - to withdraw, lift off
desto - the more (the more …, the more …)
die EC-Karte, -n - debit card
der Geldautomat, -en - ATM, automatic teller machine
das Girokonto, -konten - checking account
je - the more …, the more …
die Kontoeröffnung, -en - account opening
die Traumbank, -banken - dream bank
umsonst - for free
traumhaft - fantastic(al)
der/die Bankangestellte, -n - bank teller
die Geheimnummer, -n - secret number
der Kredit, -e - credit
die PIN, -s - PIN, personal identification number
das Portemonnaie, -s - wallet
die Eurone, -n - Euro (colloq.)
die Kohle - coal (colloq. for money)
die Kröten - toads (colloq. for money)
die Mäuse - mice (colloq. for money)
die Umgangssprache - colloquial language
der Bankkunde, -n - bank customer
das Bargeld - cash
der Betrag, -Beträge - sum, amount
dankbar - thankful(ly)
einziehen - to collect, pull in, confiscate
erhöhen - to raise, increase
die Geheimzahl, -en - secret number
die Karte, -n - card
die Kontonummer, -n - account number
kurzfristig - briefly, short-term
sperren - to cancel, block, close off, freeze
überziehen - to overdraw
wieso - why
der Bankautomat, -en - ATM, automatic teller machine
aufladen - to load up, recharge
ausführen - to execute, carry out
das Bankgeschäft, -e - banking
die Bedeutung, -en - meaning
behalten - to keep
benötigen - to need, require
beschädigen - to damage, deface
der Chip, -s - smart card, chip-and-PIN card
der Dauerauftrag, -aufträge - recurring payment, standing order
der Diebstahl, -Diebstähle - theft
einrichten - to establish, set up
entnehmen - to take from
der Fahrkartenautomat, -en - ticket machine
die Filiale, -n - branch
der Geldbetrag, -beträge - sum of money
der Geldkarten-Chip, -s - money chip
gutschreiben - to credit
der Kontoauszug, -auszüge - account withdrawal
der Neukunde, -n - new customer
der Parkautomat, -en - parking meter
umgehend - immediate(ly), prompt(ly)
der Verlust, -e - loss
verwalten - to manage, administer
wiederfinden - to find again
zuschicken - to send over
zurückerhalten - to get back
ausfüllen - to fill out
deklarieren - to decline
einzahlen - to deposit, pay in
die Globalisierung - globalization
Asien - Asia
die Auswahl - selection
der Banker,- - banker
bedenken - to consider
die Bedingung, -en - condition
betroffen sein - to be affected
beunruhigend - disturbing(ly)
die Finanzkrise, -n - financial crisis
die Forschung, -en - research
der Fortschritt, -e - progress
furchtbar - horrible
der Handyhersteller,- - mobile phone manufacturer
die Konkurrenz - competition
der Lohn, Löhne - wage, pay
problematisch - problematic(ally)
rasend - rapid, furious
spekulieren - to speculate
der Topmanager, - - top manager
überleben - to survive
wachsend - growing, expanding
der Weltmarkt - world market
der Wohlstand - prosperity
schwitzen - to sweat
das Versprechen,- - promise
das Gewissen - conscience
basieren auf - to be based on
betrügen - to betray
der Dieb,- - thief
drin - in it
einwerfen - to insert, throw in
die Gewissensfrage, -n - question of conscience
die Großtante, -n - great-aunt
herausfinden - to find out
das Kleingeld - small change
nachprüfen - to verify, re-examine